// Tutorial level to teach movement and introduce goal
CONFIG
%: Color:Green
HEADER
################################
##        COLORMANCER         ##
################################
LEVEL
################################
#@                          %  #
################################