CONFIG
%: Color:Red
Yy: Color:Red
dD: Color:Yellow
uU: Color:Cyan
DYU: Closed
HEADER
################################
## CONGRATULATIONS! YOU WIN   ##
################################
LEVEL
################################
#0202020202    U Dyy       Y%%%#
#0202020202    U Dyy       Y%%%#
#              U Dyy       Y%%%#
#@             U Dyy       Y%%%#
############## #################
##############               du#
################################